+------------------------------------------------------------------------------+
|0000000|000|0000000|00000000000|XXX|000|0000000|0000000|00000000000|000|000000|
|0000000|0000000|0000000|0000000000000000000|0000000|0000000|0000000|000|000|00|
|000|---|000|---|---|---|000|000|---|---|---|-------|-----------|000|000|---|--|
|00000000000|000|000|0000000|000|0000000|000|000|000|000|000|000|000|000|000|00|
|00000000000|000|000|0000000|000|0000000|000|000|0000000|000|000|000|0000000|00|
|000|000|000|000|000|000|000|000|000|000|0000000|0000000|000|000|000|0000000|00|
|000|---|000|---|000|000|---|000|000|000|---|000|000|-----------|000|---|000|00|
|00000000000|000|000|000|00000000000|0000000|000|000|0000000|000|0000000|000|00|
|000000000000000|000|000|000|000|---|000|000|000|000|0000000|0000000|000|000000|
|000|000|0000000|000|0000000|000|000|000|0000000|000|000|000|0000000|0000000000|
|000|-------|000|---------------|000|-----------|000|-------|000|-----------|00|
|0000000|000|000|0000000|0000000|000|000000000000000|000|000|000|000|000|000|00|
|0000000|000|000|000|000|000|000|000|000000000000000|000|000|0000000|000|000|00|
|000|000|000|000|000|000|000|000|0000000|000|0000000|000|000|0000000|000|000|00|
|000|---|000|000|000|000|000|000--------|000|---|000|-----------|000|--------00|
|000|000|000|0000000|000|000|000|0000000|000|0000000|000|0000000|000|0000000|00|
|000|000|000|0000000|0000000|000|00000000000|0000000|000000000000000|000|000|00|
|000|000|000|0000000|0000000|000|000|0000000|000|00000000000|00000000000|000|00|
|000|000|---|---|-------|000|---|000|-------|000|-----------------------|000000|
|000|000|0000000|000|0000000|000|0000000|0000000|000|0000000|000|0000000|000000|
|000000000000000|000|0000000000000000000|000|000|000|000|0000000|000|000|000|00|
|00000000000|000|000|000|00000000000|000|END|000|0000000|00000000000|0000000|00|
+------------------------------------------------------------------------------+
